NO ./textures/north.xpm
SO ./textures/south.xpm
WE ./textures/west.xpm
EA ./textures/east.xpm

F 220 100 0
C 225 30 0

 1 1 1 1 1 1 1 1 1 1
1000000001
100 1N00  001
1000000E01
1111111111