NO ./textures/mountains/leave.xpm
SO ./textures/mountains/SKY2.xpm
WE ./textures/mountains/flowers.xpm
EA ./textures/mountains/forest.xpm

F 220 100 0
C 225 30 0

11111111111111111111111111111111111111111111111111
10000000000000000000100000000000000000000000000001
10000000000000000000100000000000000000000000000001
10000000000000000000100000000000000000000000000001
10000000000000000000100000000000000000000000000001
10000000000000000000100000000000000000000000000001
10000000000000000000100000000000000000000000000001
10000111111111111111100000000000000000000000000001
10000000000000000000100000000000000000000000000001
10000000000000000000100000000000000000000000000001
10000000000000000000100000000000000000000000000001
10000000000000000000100000000000000000000000000001
10000000000000000000100000000000000000000000000001
10000000000000000000100000000000000000000000000001
10000000000000000000100000000000000000000000000001
10000000000000000000100000000000000000000000000001
10000000001111111111100000000000000000000000000001
10000000000000000000000000000000000000000000000001
10000000000000000000000000000000000000000000000001
10000000000000000000000000000000000000000000000001
10000000000000000000000000000000000000000000000001
10000000000000000011111111111111111100000000000001
10000000000000000010000000000000000000000000000001
1000000000000000001000000N0000000000000000000000001
10000000000000000010000000000000000000000000000001
10000000000000000010000000000000001000000000000001
10000000000000000010000000000000001000000000000001
10000000000000000010000000000000001000000000000001
10000000000000000010000111100000001000000000000001
10000000000000000010000000000000001000000000000001
10000000000000000010000000000000001000000000000001
10000000000000000010000000000000001000000000000001
10000000000000000010000000000000000000000000000001
10000000000000000000000000000000000000000000000001
10000000000000000000000011100000000000000000000001
11111111111111111111111111111111111111111111111111
