NO ./textures/mountains/forest.xpm
SO ./textures/mountains/batterfly.xpm
WE ./textures/mountains/lake.xpm
EA ./textures/mountains/sunset.xpm

F 50 128 0
C 0 132 230

1111111111111111111111
1000000000110000000001
1011000001110000000001
1001000000000000000001
111111110101100000111000000001
100000000011000001110111110111
11110111111111011100000010001
11110111111111011101010010001
11000000110101011100000000001
10000000000000001100000010001
10000000000000001101010010001
1100S000111010101111101111001
11110111 1110101 101111010001
11111111 1111111 111111111111
