NO ./textures/north.xpm
SO ./textures/south.xpm
WE ./textures/west.xpm
EA ./textures/east.xpm

F 210 180 140
C 135 206 235

1111111111
1000000001
1000001001
10000S1001
1000000001
1000000010
1111111111