NO ./textures/north.xpm
F 220 100 0
C 225 30 0
SO ./textures/south.xpm
WE ./textures/west.xpm
EA ./textures/east.xpm
1111111111
1000000001
1001N0001
1000000001
1111111111
